11111111111111111111
1P0000000000C0000E01
10111111111110111101
10100C00000C000C0101
10001111111100111101
10101000C000000C0101
10100C1111110C111111
10101010C00000000011
101010101111101111C1
101C00100C000C000101
10101010111110111101
1010001000C00C000001
10101010111110111101
1C00101000C00000C111
101010111111101111C1
1000100C000000000101
10101111111110111101
100C0000000000000001
10111111111110111101
10000000000000100001
11111111111111111111