11111111111
100011011C1
11000001101
10P100000E1
11111111111