111111111111111111111111111111111
1P000C00110000000100C000000111111
1111100000000100011111110001E0011
10000000C000010C01000000011100001
100000111110010001000C0010000C001
1C0000000000010001000000111111001
100000001C00010001C0000010000C001
111111001000001101001111100000001
100C000010000C0000000000000111001
10000111100C000110C0000111000C001
111111111111111111111111111111111