111111111111111111111
10C0C0000X00000000001
1010C0000P0000000X001
1000C0C1000C1110C1111
100100011000110001101
10000000X100001000011
100011011C1011C1011C1
11C100011000110001101
1E01000000X0000000001
111111111111111111111